WE Mandatory/s.png
NO Mandatory/a.png
SO Mandatory/p.png
EA Mandatory/w.png

F 220,100,0
C 225,30,0


1111111 1
111011 1N1
1111111 1