WE Mandatory/s.png
NO Mandatory/a.png
F 32,0,1
C 0,25,110
SO Mandatory/p.png
EA Mandatory/w.png


111111111111111111111111111111111111111111111111111111111111111111111111111111111111111111
1000000000000000000000000000000000000000000000000000000000000000000000000000000000000000001
111111111111111111111111111111111111111111111111111111111111111111111111111111111111111110111
                      10                                  10                                101
                      10                                  10                                101
          1111111111111111111111111111111111            10                                101
          100000000E000010101000000000000001            10                                11
          1011111111111011111111111111111101            11                                101
          101         101                101            10                                101
          101         101                101            10                                101
1111111111111111111111101111111111111111111111111111111110111                           111
1000000000100000000000000100000000000000000000000000000000001                           101
100000000010000000000000010000000000000000 0000000000000001111111111111111111 11111111111
100000000010000000000000010000000001010000 0000000000000000011000000000000000 00000000011111
1000000000100000000000000100000000010100000000000000000000001111111111111111 1111111111111111111
1000000000100000000000000100000001111111100000000000000000001                          101
1000000000100000000000000100011111000000111110000000000000001                          101
1000000000100000111100000100000001000000100000000000000000001                          101
1000000000111111100100000100001111111111111110000000000000001                          101
10000000000000000001000000000000111110000000000000000000111                               101
1000000000000000000000000001000001111111100000000000000000001                           101
1000000000000000000000000001000000001110000000000000000000001                           101
1000000000000000000000000001000000101010000000000000000000001          0                101
1000000000000000000000000001000000000000000000000000000000001                           101
1000000000000000000000001001000000000000000000000000000000001                           101
1000000000000000000000000001000000000000000000000000000000001                           101
1000000000000000000000000001000000000000000000000000000000001                           101
1000000000000000000000000001000000000000000000000000000000001                           101
10000000000000000000000000010000000000000000000000000000000011111111111111111 1111111111001
1111111111111111111111111111111111111111111111111111111111111111111111111111111111111111111