WE Mandatory/s.png
NO Mandatory/a.png
F 3,0,43
SO Mandatory/p.png
EA Mandatory/w.png
C 0,25,255


1111111111111111111111111111111111111111  
1000000000000000000000000000000000000001
10000000000000000N00000000000000000000001
11111111111111111111111111111111111111111