WE Mandatory/143-pin.xpm
NO Mandatory/a11.xpm
SO Mandatory/adechaji.xpm
EA Mandatory/neo.xpm

F 220,100,0
C 0,0,5

        111111111111111111111111
        1000000000110000000000001
        101100000111000000N000001
       1001000000000000000000001
111111111011000001110000000000001
100000000011000001110111111111111
11110111111111011100000010001
11110111111111011101010010001111
11000000110101011100000010001
10000000000000001100000010001111
10000000000000001101010010001
110000011101010111110111100111
11110111 1110101 101111010001
11111111 1111111 111111111111
