WE Mandatory/s.png
NO Mandatory/a.png
SO Mandatory/p.png
EA Mandatory/w.png

F 220,100,0
C 225,30,0

        1111111111111111111111111111111111
         111111111100000000011000000000000111
          11111111111101100000111000000000000111111111
        11111111111111111111111111111111111111111

11111111001000000000000000000001
100000000000001010101001011111111
100000000011000001110111111111111
11110111111111011100000010001
11110111111111011101010010001
11000000110101011100000010001
10000000000000001100000010001
10000000000000001101010010001
11000001110101011111011110N0111
11110111 1110101 101111010001
11111111 1111111 111111111111
