WE Mandatory/s.png
NO Mandatory/a.png
F 3,0,43
SO Mandatory/p.png
EA Mandatory/w.png
C 0,25,255


111111111111111111111111111111111111111111111
1000000000000000000001000100000000000000011
10000000000000000N001000001000000000000000111
111111111111111111111111111111111111111111