WE Mandatory/s.png
NO Mandatory/a.png
F 3,0,43
SO Mandatory/p.png
EA Mandatory/w.png
C 0,252,255


1111111
1N00000011
100000001
111111111